R 1920 1080
NO ./path_to_the_north_texture
SO ./path_to_the_south_texture
WE ./path_to_the_west_texture
EA ./path_to_the_east_texture
S ./path_to_the_sprite_texture

F 0,0,0
C 255,255,255

111111111111111111111111111111111111111
1S0000000111110100000000000100010001001
111111010000000001111111010101010101001
100001011110111100000000010101010101001
101111010010110111111111010001010101001
100000010010000000000000011111000101001
111111110011111111111110000001111101001
100000011101000000000000000000000000001
101111000001001111111111111111111110101
101001111111101000101010101010101010101
101000000000001000000000000000000000101
101111111111111011111110111111111100101
100010001000100010001000100010001000101
100000100010001000100010001000100010001
111111111111111111111111111111111111111
