R 1920 1080
NO ./path_to_the_north_texture
SO ./path_to_the_south_texture
WE ./path_to_the_west_texture
EA ./path_to_the_east_texture
S ./path_to_the_sprite_texture

F 0,0,0
C 255,255,255

111111111111111111111111111111111111111
100000000000000000000000000000000000001
100000000000000000000000000000000000001
100000000000000000000000000000000000001
100000000000000000100000000000000000001
100000000000000000000000000000000000001
100000000000000000000000100000000000001
100000000000000000S00000100000000000001
100000000001000000000000000000000000001
100000000000000000000000000000000000001
100000000000000001110000000000000000001
100000000000000000000000000000000000001
100000000000000000000000000000000000001
100000000000000000000000000000000000001
111111111111111111111111111111111111111
